Maze by Joe Wingbermuehle 19990805
*-*************************************************************************************************************************
*-*---------------------*  ---            *       *     *         *   *                     *         *     *   *         *
*-*-*** * ********* ***-***-*-*** ***** * * * *** *** * * * ***** * * * * *************** *** ***** * * * * * * ***** *** *
*-*---* *     *---*   *---*-*---* *   * *   *   *     *   *     *   *   *       *   *   *     *     *   * *   *   *   *   *
*-* *-******* *-*-* * ***-*-***-* * * *** ***** *************** * ***** ***** * * * * * ******* * ******* ******* * * * ***
*-* *---* *   *-*-* * *---*---*-*   *   *     *       *   *   * * *   * *   * * * *   *     *   * * *     *     *   * *   *
*-* ***-* * * *-*-*** *-*****-*-******* ***** * ***** * * * * * * *** * *** *** * *** ***** * * * * * ***** * * ********* *
*-*   *-* * * *-*---* *-*-----*-  *   *   *   *   *   * * * *   *   * *     *   *   *     * * * *   *       * *       *   *
*-*****-* * ***-* *-***-*-*****-* * * *** ******* * ***** ***** *** * * * *** ***** ******* * * ************* ******* *** *
*-------*   *---* *-----*-----*-* * *   *   *   * *     *     *   *   * *   *     * *   *   * *       *     * *     *   * *
* ***********-******* *******-*-* * ******* * * * ***** ***** *** ***** * * ***** * * * * *** ***** * ***** * * *** * * ***
*         * *---*---* *-------*-*   *       * *   *   *       *   *   * * *     *   * *   *   *   * *     * * * *   * *   *
* *** *** * * *-*-*-***-* *****-***** ***** * ***** * ********* *** * * *** *** *** * ***** *** * ******* * * *** * * * * *
*   * *   * * *-*-*-----*     *-----* *   * * *   * *     * *   * * * *   *   *   * *     *   * *   *     * *     * * * * *
*** * * *** * *-*-* ******* * *****-* * * *** * * * * *** * * *** * * *** * * *** *** *** *** * *** * ***** ******* * * * *
* * * *   * * *---*       * * *-----* * *   *   *   * *   *   *   * *   * * * * *   *   * * * *   * *       *   *   * * * *
* * * *** * ************* * * *-***** * *** ********* * * ***** *** *** * * * * *** *** * * * ***** *********** ***** *** *
* * * *   *     *     *   * * *-*   * * *   *   *     * *     *   * *   * * * * *   *   *   *     * *   *   *   *   *   * *
* * *** ******* * ***** * *** *-* * * * *** * * * ***** ***** *** * * *** * * * * *************** * * * *** * *** * *** * *
* *   *   *     *       * *   *-* *   *   * * * * *     *   *   *   *     * *   *     *         *   * *     *   * * *   * *
* *** *** * * ************* ***-* * ***** * * *** * ***** * ********* ***** ********* * * ***** * *** * ******* * * * *** *
* *   *   * * *   *   *     *---* *   *   * * *   *   *   * *       *   * *         *   * *     *   * *       *   *   * * *
* * *** *** * * *** * * *****-*** ***** ***** * ***** * * * * ***** * * * * *** * * * *** * ******* * ***** * ********* * *
*   *   *   * *   * *   *---*-*   *   * *   *   *   * * * * * *   * * *   *   * * * * *   * *   *   *     * *           * *
* *** *** * * *** * *****-*-*-* *** * * * * * *** * * * * * *** * * ********* * *** * * *** * *** ******* * *** ********* *
* * *     * *     *     *-*---*     * * * * * *   * *   * *     * *     *     * *   * *   * *     *       *   *       * * *
* * * ***** *** ******* *-*********** * * * *** * * ***** * ***** ***** * ******* * * ***** ******* * ******* * ***** * * *
*   * *   *   *       * *-----------*   * * *   * * *     *   *   *     * *       * *   *   *     * * *   *   *     *   * *
* * * * * *** *** *** * ******* ***-***** * * * *** ***** *** * *** * ***** ******* * * * *** *** * * * * * ******* * *** *
* * *   *   *   * * * *       *   *---*---*   * *   *   *   * * *   * *     *   * * * * * *   * * * *   * *   * *   * *   *
* ************* * * * ******* *******-*-*-******* *** * ***** * * *** * ******* * * * * * * *** * * ***** *** * * ***** ***
*     *         *   * *     * *   *---*-*-  *     *   *   *   * *   * *         * * * * * *   * *   *   *   * *   *   *   *
* *** * ******* ***** * * *** * * *-***-*-* * * *** ***** * *** * * * *** ******* * *** * *** * ***** ***** * ***** * *** *
* *   *   *   * *   *   * *   * * *-*---*-* * * *   * *   * *   * * *   * *       * *   *   * *     * *     * *     *   * *
* * ***** * * *** * ******* *** ***-*-* *-* * *** *** * * *** ***** * * *** * * *** * ***** * ***** * * ***** * ******* * *
* *     *   *     *   *   *     *---*-* *-* *     * *   * *   *     * *     * *   * *     * * *   * *   *     *     * *   *
* ***** ************* * * *******-***-***-* ******* ******* *** * *** ******* * * * ***** * * * * * * *** ***** *** * * ***
*     *             *   *   *   *-*---*---*         *     *     * *   *       * * *     * *   * *   * *   *   * *   * *   *
* *** * *********** * ***** *** *-*-* *-* *************** * ***** * *** ******* * ***** * ***** ******* ***** * * *** * * *
* *   *     *       * *   *     *-*-* *-*         *     * *   * * * *   *   *   *   *   *       *     *       * * *   * * *
* * ******* * *** *** * * ***** *-*-* *-***** ***** * * * *** * * * ***** * ******* * *************** ********* * * * * * *
* * *     * *   *   * * * *   * *-*-* *-----* *---* * *   * *   * *   *   *     *   * *               *     *   *   * * * *
* * ***** ***** * * * * * *** * *-*-* *****-***-*-* * ***** ***** *** * ******* * *** * * ************* *** * * ***** * * *
* *       *   * * * *   * *   * *---*   * *-----*---*       *     *   * *     * * * *   *           *   * *   *     * * * *
* ********* *** * * * *** * ******* *** * * *******-********* ***** ***** * * * * * ***** ********* * *** * *** ***** * * *
*           *   * * * * * * *     * *   * *       *---------*     *       * * * *   *   *       * * *   * *   * *     * * *
* *********** ***** * * * * * *** * * * * ******* * *******-***** ***** ***** * ***** * * ***** * * *** * *** *** ***** * *
*           * *     *   * *   *   * * * *   * *   * *   * *---*   *   * *     *     * * *     *   *   *   *   *   *   * * *
* ********* * ********* * ***** * * * * *** * * *** * * * * *-* *** * *** ********* * * ***** ******* ********* *** * *** *
*   *   * * *         * * *     * * * * *   * * *   * *   * *-*     *   *         * * * *   * *     *     *   *   * *     *
* * * * * * *** * *** * * * * *** * * *** *** * * *** * *** *-***** *** ********* * * * * * * * *** ***** * * ***** ***** *
* *   * * *   * * *   * *   *   * * *   *   *   *     *   * *-----*   * *       *   * * * *   * *   *   * * *     *     * *
* ***** * * * * *** ******* ***** * *** *** * ************* *****-*** * * *** * ******* * ***** * *** * * * ***** * *** ***
*   *   * * * * *   *     *   *   *   *     * *   *         *   *---* * *   * *       * *     * *     * * *     * *   *   *
* * * *** *** * * * ***** *** * ***** ***** * * * * ********* * ***-* * *** ********* * ***** * * ******* ***** * *** *** *
* * *     *   * * * *   * *   * *     *   * *   * *           *   *-* *     *       * * *     * *   *   * *     *   *   * *
* * ******* * *** * * * * * * * * ******* * ***** ************* * *-* ******* ***** * * * ***** *** * * * * ***** * ***** *
* *       * * *   * * *   * * * *   *   * *     *     *       * * *-* *       *     * * *       *   * *   * *   * * *   * *
* ********* * * ***** * *** *** * * *** * *** * ***** * ***** * * *-*** *** *** ***** * * * ***** *** * *** * * * * * * * *
* *     *   * *       *   * *   * * *   *   * *   *   * *     * * *---*   * *   *   *   * * *     *   *   * * * * *   * * *
* * *** * *** ************* * *** * * ***** * ***** * * * ***** * ***-*** * * ***** ***** * * ***** ***** * * * ******* * *
*   *   * *   *   *         *   * * *   *   * * *   * * *     * * * *-    * *   *   *   * * * *     *   * * * *   *   *   *
* *** *** * *** *** ***** ***** *** *** * * * * * ***** ***** * * * *-***** *** * * * * * * * * ******* *** * *** * *******
* * * *   *     *   *   *     *   * *   * * *   *   *   *     * * * *-----* * *   * * *   * * *   *   *   *   * * *       *
* * * * ********* *** * ***** *** * * *** * ******* * *** ******* * *** *-* * * ***** * *** * *** * * *** ***** * ******* *
*   * *         *   * * *   *   * *   *   *       *   * * *       *   * *-*   *   *   *   * *   * * *     *     *       * *
***** ***** *** ***** * * * * * * ***** * *** *** ***** * * ********* * *-******* * ******* * * * * * ***** *********** * *
*   *     * *   *     *   * * * *       *   *   *       * *   *       * *-------* * *     * * * * * *   *   *   *   * *   *
* * ***** * * *** ***** *** * * ***** ***** ******* ***** *** * *** *** ***** *-* * * * * * *** * * *** * *** * * * * * ***
* *     * * *   * *   * *   * *     *     *   *   *     *   * *   * *   *   * *-* * * * * *   * *   *   * *   *   *   * * *
* ***** * ***** *** * *** * * ***** * * * *** * * ***** * * * *** * * *** * ***-*** * * * * * * * *** *** * *********** * *
* *   *   *   *   * *     * *   *   * * * * *   *   *   * * *   * * *     *   *---*   * * * * * *   * *   *   *       *   *
* * * ***** * *** * * *********** *** * * * * ***** ***** * *** * * ********* * *-******* * * * *** * * ***** * * *** *****
*   *   *   * * *   * * *         * * * *   *     *   *   * *   * * *     *   * *---*     * * *   * * * *     * *   *     *
* ***** * *** * * *** * * ******* * * * ************* * *** * *** * * *** * *******-* ***** * *** *** * * ***** *** *** * *
* *   *   * *   *   *   * * *   * *   * *     *       *   * *   * * * * * * *   *---* *   * *   *   * * * *   *   *   * * *
* * * ***** * ***** ***** * * * *** *** * * * * *********** * * * *** * * *** * *-*** *** * *** *** *** * * * *** *** * * *
*   * *     *     * *     *   *   *   *   * * *   *   *     * *   *   * *   * * *-*   *   *   *   *     * * *   * *   * * *
* *** * * * ***** * * * ********* * * ******* *** * * * * *** ***** *** * * * * *-* *** ***** *** ******* * *** * * ***** *
* *   * * *     * * * *   *       * * * *     *   * *   *   * *   * *   * * * *---*     *     *   *       *   *   *     * *
*** *** * * *** * * * ***** * ***** * * * ***** *** ******* * * * * * *** * * *-*** ***** ***** *** ********* * ******* * *
*   *   * * *   * * *     * *     * *   * *     * *       * * * * *   *   * * *---*     *     *     *     *   * *   *   * *
* *** * * * * *** * ***** * * *** * ***** * ***** * ***** * * * * ******* * * ***-* *** * *** ******* * * * ***** * * *** *
*     * * * * *   *     *   *   * *     * *       *   *   * *   *       * *   *---*   * *   *         * *   *     * * * * *
******* * *** * ******* * ******* ***** * ******* ***** ********* ***** *******-******* ********************* ***** * * * *
* *     * *   * *       *   *   *     * *       *   *   *   *   *     *   *   *-------* *---*-----*         * *   * * * * *
* * ***** * *** * *********** * * ***** * ***** ***** *** * * * *** * *** *** * *** *-***-*-*-* *-* * ***** * *** * * * * *
*   *   * *   * *     *       * * *     *     *   *   *   * * *   * *   *     *   * *-----*-*-* *-  *     * *   * * * * * *
* *** * * *** * * *** * ******* * * ************* * ******* * *** * *** ********* * *******-*-***-******* * *** * * * * * *
* *   *   *   * * *   * *       * *           *   *     *   *   * *   *     *   * * *     *-*---*-------* * *   *   * * * *
* * * ********* *** ***** * * * * *********** * ***** * * ***** * *** ***** * * * * * *** *-***-*******-* * * ******* * * *
* * *   *     *   *   *   * * * *   *       * *     * * *       *   *     * * *   *   *   *-----*   *---* *   * *   *   * *
* * ***** *** *** *** * *** * * *** * * ***** ***** *** * ********* * *** * *** ******* * ******* * *-*** ***** * * ***** *
* *     * * *   *   *   *   * *   *   *   *   *   * *   *   *     * *   * *   * *   * * * * *   * * *-  *       * *     * *
* * *** * * *** * * ********* *********** * *** * * * ******* *** * * * * *** *** * * * * * * * *** *-* ********* ***** * *
* *   *   *     * *       * *     *     * *   * * * *         * *   * * *   *   * * *   *   * *   * *-*         *     *   *
* *************** ******* * ***** * *** * *** * *** *********** * * * * * * *** *** ********* * * * *-********* ***** *****
*   *           *       * * *     * *   * *   *   *       *     * * * * * *   *   * *       * * *   *---------*     * *   *
* * * ***** *** * ***** * * * ***** * * *** ***** * ***** * ***** * * * ***** *** * * ***** * * *************-******* *** *
* * * *   *   * * *   * * *   *     * * *   *   * * *   *   *     * * *     *   *   * *   *   *             *-----*   *   *
* * * *** * * * *** * *** ***** ***** * * *** * * * * * *********** * ***** *** ***** * * * *************** * ***-* *** * *
* *   *   * * * *   *   *     * *   * * *   * *   * * *     *   *   *   *   * *   *   * * *             *   *   *-*     * *
* ***** * *** * * *** * ***** * * *** * *** * ******* * *** * * ***** * * *** * * * ***** * *********** * * *** *-*********
*   *   * *   * *   * *     * * *     *   *   *       * *   * *     * * * *   * *   *     * *   *       * *   * *-*-------*
* * * ***** * * *** ********* * ******* * * *** ***** *** * * ***** *** * * *** ***** * *** * * * ******* *** * *-*-*****-*
* *   *   * * *   *         * *       * * *   * *   * *   * *   *   *   * * *   *     * *   * *   *       *   * *---*   *-*
* ***** * * * *** ********* * * ***** * * ***** * * *** * * *** * *** *** * ***** * ***** *** * *** *********** ******* *-*
*     * *   *   *     *   *   * *   * * *     * * *   * * * * * *   * *   *     * *   *   *   *   *     *       *     * *-*
******* ***** * ***** * * ******* * * * * *** * * *** * * * * * *** * * ******* * ***** *** *********** ********* *** * *-*
*       *   * * * *   * *         *   * *   *   * *   * * *   *   * * *       * * *   * *   *     *   *     *   * * *   *-*
* ***** * * * * * * *** * ************* ********* * *** ******* * * * ******* * * * * *** *** * * * * ***** * * * * * ***-*
*     * * * * * * *     *             *   *       *   *       * * *   *     *   * * *     *   * * * *     *   *   * * *---*
* *** * * * * * * * ***************** * * * * ******* ******* * * ***** *** ***** * ******* * * * * ***** ********* * *-***
* *   * * * * *   *         *   *   * * *   *       *   *     * *     *   *     * *         * * *   *   *         * * *---*
*** ***** * *** ************* * * * * * *************** * ***** * * * *** ***** * * *********** ***** * ********* * *****-*
*   *   * *   *     *     *   * * * * *   *         *   *   *   * * *   *   * *   *       *   * *     *         *   *   *-*
* *** * * *** ***** * * * * *** * *** *** * ******* * ***** ***** * *** *** * * ********* * * * * * *********** ***** ***-*
* *   *   *   *   * * * * * *   * *   *   *     *   * *   *   *   *   *     * * *     *   * *   * *     *     *     *   *-*
* ********* ***** * * *** * * * * * ******* ***** *** * * *** * ***** ******* * * ***** * * ***** ***** * * * ***** *** *-*
* *         *   *   *   * * * * *   *     * *   *     * *     *     *         *   *     * *       *   *   * * *   *   *---*
* * ********* * ******* * * * ******* * * *** * ******* *********** *************** ***** * ******* ********* * ***** *-***
*   *         *         *   *         * *     *         *           *               *     *       *           *       *---*
*************************************************************************************************************************-*
